11111111111111111111111
11110000001110000000001
1P0000001000000000000C1
1111100000000C000000001
100000C00001111100000E1
10000001110C00000000001
11111111111111111111111
