111111111111111111111111111111111111
10000000000000000000001CC10000000001
1000C000000001111110001CC00000000E01
10000000000000000000001CC10000000001
10000000C111C00000000011111000000011
10000000000000000000001CCC1000011111
111110000001000000011011000000000001
111111100001C1000001CCC100001C100001
10000010100011000001111100001C111111
1000001C1000000000111111000001111111
1110001C1000111111000000000011111111
1110001CC10000000000000C000111111111
10000001C00001CC10111111111111111111
10000111C10001CC10111111111111111111
10000001110001CC101111111111000000C1
111111111111111110000CCCC000011111C1
1P00000000000000001111111111C1111111
111111111111111111111111111111111111
